#B####
#   ##
##  ##
 # ###
#   ##
###A##