######
###B##
##  ##
## ###
##  ##
###A##