#########################################
#A    #       #     #         #         #
##### # ##### # ### # ####### # ##### # #
#     # #   # # # # #       # # #   # # #
# ##### # # # # # # ####### # # # # # # #
# #     # #   # # # #       # #   # #   #
# # ##### ##### # # # ######### ### ### #
# # #   #     # # # #     #     #     # #
# # # # ##### # # # ##### # ##### ### # #
# #   #     # #   #     # #     # #   # #
# ######### # ######### # ##### # # ### #
#       #   #     #   # #   #   # #     #
####### # ####### # # # ### # ### ##### #
#       #     #   # # #   # #   #     # #
# ######### # # ### # ### # ### ##### # #
#     #     # # #   #   # #   #     # # #
##### # ##### # # ##### # ### ##### # # #
#   # #     # # # #     #   # #     # # #
# # # ##### # # # # ####### # # ##### # #
# # #     # #   # # #     # # #     # # #
# # ##### # ##### # # ### # # ##### # # #
# #     # #     # # # # # # #     # # # #
# ##### # ##### # # # # # # ##### # # # #
#     # #     # # #   # # # #   # # # # #
##### # ##### # # ##### # # # # # # # # #
#     #     # # #     # # # # # # # # # #
# ######### # # ##### # # # # # # # # # #
# #       # # #     # # #   # # # # # # #
# # ##### # # ##### # # ##### # # # # # #
# # #   # # #     # # #     # # # # # # #
# # # # # # ##### # # ##### # # # # # # #
#   # #   #     #   #     #   #   #   # #
### # ######### ######### ######### ### #
#   #         #         #         #    B#
#########################################