#B####
#  ###
## ###
## ###
##  ##
###A##