#                 #############
# #############################
#                            ##
####################### ## # ##
#   ##                  ## # ##
# # ## ### ## ######### ## # ##
# #    #   ##B#         ## # ##
# # ## ################### # ##
### ##                #### # ##
### ################# #### # ##
###                      # # ##
###### ######### ####### # # ##
###### #####             #   ##
A      ########################