#########################################
#A    #       #     #         #         #
# ### # ##### # ### # ####### # ##### # #
# #   # #   # # # # #       # # #   # # #
# # ### # # # # # # ####### # # # # # # #
# #     # #   # # # #       # #   # #   #
# ##### ##### # # # ######### ### ### # #
# #   #     # # # #     #     #     # # #
# # # ##### # # # ##### # ##### ### # # #
# # #     # #   #     # #     # #   # # #
# # ##### # ######### # ##### # # ### # #
# #     # #     #   # #   #   # #     # #
# ##### # ##### # # # ### # ### ##### # #
#     # #     # # # #   # #   #     # # #
##### # ##### # # # ### # ### ##### # # #
#     #     # # # #   # #   #     # # # #
# ######### # # # ### # ### ##### # # # #
# #       # # # # #   #   # #     # # # #
# # ##### # # # # # ##### # # ##### # # #
# # #   # # # # # # #     # #     # # # #
# # # # # # # # # # # ##### ##### # # # #
# #   # # # # # # # #     #     # # # # #
# ##### # # # # # # ##### ##### # # # # #
#     # # # # # # #     #     # # # # # #
##### # # # # # # ##### ##### # # # # # #
#     # # # # # #     #     # # # # # # #
# ##### # # # # ##### ##### # # # # # # #
# #     # # # #     #     # # # # # # # #
# # ##### # # ##### ##### # # # # # # # #
# #     # # #     #     # # # # # # # # #
# ## ## # # ##### ##### # # # # # # # # #
#     #   #     #     #   #   #   #   # #
##### ######### ######### ### ##### ### #
#                                   # B #
#########################################